cancerType	group
TCGA-CESC	KZFP_low
TCGA-UCEC	KZFP_low
TCGA-READ	KZFP_low
TCGA-COAD	KZFP_low
TCGA-ESCA	KZFP_low
TCGA-HNSC	KZFP_low
TCGA-LUSC	KZFP_low
TCGA-KIRP	KZFP_low
TCGA-KIRC	KZFP_low
TCGA-BLCA	KZFP_low
TCGA-STAD	KZFP_low
TCGA-BRCA	KZFP_low
TCGA-GBM	KZFP_low
TCGA-KICH	KZFP_low
TCGA-PRAD	KZFP_low
TCGA-LUAD	KZFP_high
TCGA-PAAD	KZFP_high
TCGA-CHOL	KZFP_high
TCGA-LIHC	KZFP_high
TCGA-SKCM	KZFP_high
TCGA-SARC	KZFP_high
TCGA-THCA	KZFP_high
TCGA-PCPG	KZFP_high
